....................
....................
....................
....................
......######........
......#.............
......#.............
....................
....................
....................
......#.............
......#.............
......#.............
......#.............
......#######.......